abaca	abaca	Nom:Mas+SG
abaisser	abaisser	Ver:Inf
abaissons	abaisser	Ver:IPre+PL+P1
abaissiez	abaisser	Ver:IImp+PL+P2:SPre+PL+P2
abandonner	abandonner	Ver:Inf
abandonnent	abandonner	Ver:IPre+PL+P3:SPre+PL+P3
armure	armure	Nom:Fem+SG
arnaques	arnaque	Nom:Fem+PL
arpeges	arpege	Adj:Mas+PL
arquee	arque	Adj:Fem+SG
arquees	arque	Adj:Fem+PL
arquer	arquer	Ver:Inf
arrachages	arrachage	Nom:Mas+PL
arrachage	arrachage	Nom:Mas+SG
arrachait	arracher	Ver:IImp+SG+P3
arriere	arriere	Adv
topiez	toper	Ver:IImp+PL+P2:SPre+PL+P2
topinambours	topinambour	Nom:Mas+PL
topinambour	topinambour	Nom:Mas+SG
topions	toper	Ver:IImp+PL+P1:SPre+PL+P1
topique	topique	Adj:InvGen+SG
topique	topique	Nom:Fem+SG
topique	topique	Nom:Mas+SG
topographes	topographe	Nom:InvGen+PL
topographe	topographe	Nom:InvGen+SG
topographie	topographie	Nom:Fem+SG
topographiquement	topographiquement	Adv
topographiques	topographique	Adj:InvGen+PL
topographiques	topographique	Adj:InvGen+PL